                               
           #############   ########
           #      #   ####       #
           #  #  #                #
           #           ######################
           ##########                       #
                   ################  #       
                   ###                      #   #####
                     #                #####    #B
                     ########################   #####