                               
           #############  #########
           #      #   ####       A#
           #  ####                #
           #           ######################
           ##########                       ############
                   ################  #   #             #
                     #                      #   #####  #
                     ##               #####    #B      #
                     ###################################