









              ###############################
              # #      #    #               #
              #    # A #  # #    # #######  #        
              #  #######  # ###### #    B#  #       
              #           #        #  ####  #  
              ######################     #  # 
              #   #          #       #   #  #  
              #          #       #       #  # 
              #   ########################  #                      
              #                          #  #
              ### ########################  #                           
              #                             # 
              ###############################
