









              ###############################
              # #           #               #
              #    # A #  # #    # #######  #        
              #  #######  # ###### #   #B#  #       
              #           #        #  ####  #  
              ######################     #  # 
              #   #          #       #   #  #  
              #          #       #       #  # 
              #   ########################  #                      
              #                          #  #
              ### ########################  #                           
              #                             # 
              ###############################
