              ###################################################
              # #      #    #               #              # # B#
              #    # A #  # #    # #######  #                #  #
              #  #######  # ###### #     #  #                   #
              #           #        #  ####  #   #################
              ######################     #  #                   #
              #   #          #       #   #  #                   #
              #          #       #       #  #                   #
              #   ########################  #                   #  
              #                          #  #                   #
              ### ########################  #                   #        
              #                             #                   #
              ################# ############################    #
              #                             #                   #
              ##### #########################    ###########    #
              #                             # ###          ###  #
              ######################## ######           ####    #
              #                             ###########    ## # #
              ############# #################                   #
              #                             # ###################
              ################### ########### #
              #                             # #
              ###### ######################## #
              #                             # #
              ############################ ## #
              #                             # #
              ## ############################ #
              #                             # #
              ############## ################ #
              #                               #
              #################################